WWWWWWWWWWWWWWWWWWWWW
WWWWWWWW00000WWWWWWWW
WWWWWWWW00M00WWWWWWWW
WWWWWWWW0P000WWWWWWWW
WWWWWWWW000F0WWWWWWWW
WWWWWWWWWWWWWWWWWWWWW
WWWWWWWWWWWWWWWWWWWWW
WWWWWWWW00000WWWWWWWW
WWWWWWWW00M00WWWWWWWW
WWWWWWWW00000WWWWWWWW
WWWWWWWW000F0WWWWWWWW
WWWWWWWWWWWWWWWWWWWWW
